Generated Maze:
+---+---+---+---+---+---+---+---+---+---+---+---+---+---+---+---+---+---+---+---+---+---+---+---+---+---+---+---+---+---+
|       |                   |                           |                                       |               |       |
+---+   +---+   +---+   +   +---+   +---+---+---+---+   +   +---+---+---+---+---+---+   +---+   +   +---+---+   +---+   +
|   |       |   |   |   |       |       |               |   |   |       |           |   |   |       |       |       |   |
+   +---+   +   +   +   +---+   +   +   +   +---+---+---+   +   +   +   +   +---+   +   +   +---+---+   +   +---+   +   +
|       |   |       |   |       |   |   |   |           |       |   |       |           |           |   |   |   |   |   |
+   +---+   +---+---+   +   +---+   +   +   +   +---+   +---+---+   +---+---+---+---+---+---+   +   +   +   +   +   +   +
|           |           |   |       |   |       |   |   |       |                   |           |       |       |   |   |
+   +---+---+   +---+---+   +---+---+   +---+---+   +   +   +   +   +---+---+---+   +   +---+   +---+---+---+   +   +   +
|       |           |   |   |       |       |               |   |   |           |   |       |   |           |   |       |
+---+   +---+---+   +   +   +   +   +---+   +---+---+---+---+   +   +---+   +---+   +---+   +---+   +---+   +   +---+   +
|   |               |   |       |   |       |       |       |   |       |       |       |           |   |   |       |   |
+   +---+---+---+---+   +---+---+   +   +---+   +   +   +   +   +---+   +   +   +---+   +   +---+---+   +   +---+   +   +
|                       |       |   |   |       |   |   |   |   |       |   |       |   |   |           |   |       |   |
+   +---+   +---+---+   +   +   +   +   +   +---+   +   +   +   +   +---+---+   +---+   +   +   +---+   +   +---+---+   +
|       |           |       |   |   |   |   |   |       |   |   |               |       |   |       |   |   |       |   |
+---+---+---+   +   +---+---+   +   +   +   +   +---+---+   +   +---+---+---+---+   +---+   +---+   +   +   +   +   +   +
|           |   |       |       |   |   |   |           |   |           |           |   |       |   |   |       |       |
+   +---+   +   +---+   +   +---+   +   +   +   +---+---+   +---+---+   +   +---+---+   +---+   +   +---+---+---+---+---+
|       |   |       |   |   |       |       |   |           |       |       |   |               |                       |
+   +   +   +---+   +   +---+   +---+   +---+   +   +---+---+   +---+---+---+   +   +---+---+---+   +   +---+---+---+   +
|   |   |   |       |       |       |   |       |   |                           |   |           |   |               |   |
+   +   +   +---+---+---+   +---+   +   +   +   +   +---+---+   +---+---+   +---+   +   +---+   +---+   +---+---+   +---+
|   |   |                   |       |       |   |           |   |       |   |       |       |       |           |       |
+   +   +---+---+---+---+---+   +---+---+---+   +---+---+   +   +---+   +   +   +---+---+   +---+   +   +---+---+---+   +
|   |                           |       |   |       |       |           |       |           |       |   |       |       |
+   +---+---+---+---+---+---+---+   +   +   +---+   +   +---+---+---+   +---+---+   +   +---+   +---+---+   +   +   +---+
|               |               |   |   |           |               |           |   |   |   |   |           |   |       |
+---+---+---+   +---+   +---+   +   +   +   +---+---+---+---+---+   +---+---+   +   +   +   +   +   +---+---+   +---+   +
|           |       |   |           |   |   |       |               |           |   |   |       |   |       |           |
+   +---+---+---+   +   +---+---+---+   +   +   +   +   +---+---+---+   +---+---+---+   +   +---+   +   +   +---+---+   +
|               |   |   |       |   |   |   |   |   |   |           |       |           |   |           |       |       |
+   +---+---+   +   +   +   +   +   +   +---+   +   +   +   +   +---+---+   +   +   +---+   +---+---+---+---+   +---+   +
|   |   |       |   |       |   |       |       |       |   |       |       |   |   |           |           |       |   |
+   +   +   +   +   +---+---+   +   +---+   +---+---+---+---+---+   +   +---+   +   +---+---+   +   +---+   +   +   +---+
|   |   |   |   |       |       |           |                       |       |   |           |       |       |   |       |
+   +   +   +   +---+   +   +---+---+---+---+---+---+   +---+---+---+---+   +---+---+   +   +---+---+   +---+---+---+   +
|       |   |       |   |       |               |       |           |       |       |   |       |                       |
+---+---+   +---+---+   +   +   +---+---+   +   +   +   +   +---+   +   +---+   +   +---+---+   +---+---+---+---+---+   +
|           |           |   |   |           |       |   |   |       |   |       |           |           |           |   |
+   +---+---+   +---+---+   +   +   +---+---+---+   +---+   +   +---+   +   +---+---+---+   +---+---+   +   +---+   +   +
|       |       |           |   |   |               |       |   |       |   |           |           |   |   |   |   |   |
+   +   +   +---+   +---+---+   +   +---+   +---+---+   +---+   +   +---+   +---+   +---+---+---+   +   +   +   +   +   +
|   |       |       |   |       |       |   |               |   |           |       |           |       |   |   |       |
+   +---+---+---+   +   +   +---+---+   +   +   +---+---+---+   +---+---+---+   +   +   +---+   +---+---+   +   +---+---+
|   |           |       |   |           |   |   |       |               |       |   |       |               |           |
+   +---+   +   +---+   +   +   +---+---+---+   +   +---+   +---+---+   +---+   +   +---+   +---+---+---+---+   +---+   +
|           |   |       |   |   |           |       |       |       |           |       |   |       |           |   |   |
+---+---+---+   +---+   +   +   +   +---+   +---+   +   +---+   +---+---+   +---+---+---+   +   +---+   +   +---+   +   +
|           |       |   |   |   |   |   |   |       |       |               |           |   |   |       |   |           |
+   +   +   +---+   +   +   +   +   +   +   +   +---+---+   +---+   +---+---+   +---+   +   +   +   +---+   +---+---+---+
|   |   |       |   |   |   |   |   |   |   |   |       |       |   |           |   |       |   |   |       |           |
+   +   +---+   +   +---+   +   +   +   +   +   +   +   +---+   +---+   +---+---+   +---+---+   +   +   +   +   +---+   +
|   |       |   |   |       |   |       |   |   |   |       |   |       |                   |       |   |   |   |       |
+   +---+   +---+   +   +---+   +---+   +   +   +   +---+   +   +   +---+   +---+---+---+   +---+   +   +   +   +   +   +
|   |   |   |       |       |           |   |   |       |   |       |           |       |       |   |   |   |   |   |   |
+   +   +   +   +---+   +   +   +---+---+   +   +---+---+   +---+---+---+   +   +   +   +---+   +   +   +---+   +   +   +
|       |   |       |   |   |           |       |           |           |   |   |   |       |   |   |           |   |   |
+---+   +   +---+   +---+   +---+---+   +---+---+   +---+   +---+   +   +---+   +   +---+   +   +---+---+---+---+   +   +
|       |                   |                       |               |           |       |                           |   |
+---+---+---+---+---+---+---+---+---+---+---+---+---+---+---+---+---+---+---+---+---+---+---+---+---+---+---+---+---+---+
