Generated Maze:
+---+---+---+---+---+---+---+---+---+---+---+---+---+---+---+---+---+---+---+---+
|       |       |                               |       |                   |   |
+---+   +---+   +   +---+---+---+---+   +---+   +   +   +   +---+   +---+   +   +
|   |       |   |   |           |   |       |       |   |   |       |           |
+   +---+   +   +   +   +---+   +   +---+   +---+---+   +---+   +---+   +---+---+
|           |   |   |       |       |   |       |   |       |       |   |       |
+   +---+---+   +   +---+   +---+   +   +---+   +   +---+   +---+   +   +   +   +
|       |       |       |       |           |   |       |   |       |   |   |   |
+---+   +   +---+---+   +---+   +   +---+---+   +   +---+   +   +---+   +   +   +
|       |   |                   |   |       |   |   |       |   |       |   |   |
+   +---+   +   +---+---+---+---+---+   +   +   +   +   +---+   +---+   +   +   +
|   |       |   |   |                   |   |   |   |   |   |       |   |   |   |
+   +   +---+   +   +   +---+---+---+---+   +   +   +   +   +   +   +---+   +   +
|   |   |       |   |   |       |   |       |   |   |   |   |   |           |   |
+   +   +   +---+   +   +   +   +   +   +---+   +   +   +   +   +---+---+---+   +
|   |               |   |   |   |   |   |       |       |       |           |   |
+   +---+---+---+---+   +   +   +   +   +   +---+   +---+---+   +   +---+---+   +
|           |       |   |   |   |           |       |       |   |       |       |
+---+---+   +   +   +   +   +   +---+---+---+   +---+   +   +   +---+   +   +---+
|       |   |   |   |       |       |           |       |   |           |       |
+   +   +   +   +   +---+---+   +   +---+---+   +   +---+   +---+---+   +---+   +
|   |   |   |   |   |       |   |           |   |   |   |   |       |   |       |
+   +---+   +   +   +   +   +   +---+---+   +   +   +   +   +   +---+   +   +   +
|           |   |       |   |   |           |       |       |           |   |   |
+   +---+---+   +---+---+   +---+   +---+---+---+---+   +---+---+---+---+   +---+
|           |       |   |       |       |   |       |   |               |       |
+---+---+   +   +   +   +---+   +   +   +   +   +   +   +---+   +---+   +---+   +
|           |   |   |           |   |   |       |   |       |       |       |   |
+   +---+---+   +   +---+---+   +---+   +   +---+   +---+   +---+   +---+   +   +
|   |           |   |       |           |       |       |       |   |   |   |   |
+   +---+---+---+   +   +   +---+---+---+---+---+   +---+---+   +   +   +   +   +
|       |       |       |   |                   |           |   |   |           |
+---+   +   +   +---+---+   +   +---+   +---+   +   +---+   +   +   +---+---+   +
|   |       |           |   |   |       |       |       |   |   |       |       |
+   +---+---+---+---+   +   +---+   +---+---+   +---+---+   +   +   +   +---+   +
|               |       |   |       |       |               |   |   |       |   |
+   +---+---+   +   +---+   +   +---+   +   +---+---+---+---+   +---+---+   +   +
|           |   |           |   |       |   |       |           |           |   |
+   +---+   +---+---+---+---+   +   +---+   +   +   +   +---+---+   +---+---+   +
|       |                               |       |                   |           |
+---+---+---+---+---+---+---+---+---+---+---+---+---+---+---+---+---+---+---+---+
